7 8 2 1 4 5 9 3 6 1 7 5
####
#  #########
#    ##    #
# $$$#     #
##...# #$$$#
 #...# #...#
 #$$$  #...##
 #    ##$$$ #
 ####### @  #
       ######