5 12 45 1
  ####  
  #..#  
 ## .## 
 #  $.# 
## $  ##
#  #$$ #
#  @   #
########