45 12 3
#####
#   #####
# $ #   #
#   #$# #
###$    #
 #   ####
 # @...#
 #######