1 99
 ###########
##         #
#          #
# $  $     #
#. @      .#
############