21
    #####
    #   #
  ###   ##
  #      #
### # ## #   #######
#   # ## #####     #
#    $            .#
##### ### #@##     #
    #     ##########
    #######