5 2 12
#####    
#   #    
# $@#    
# $$# ###
### ###.#
 ##    .#
 #   #  #
 #   ####
 #####   