5
############
#  @    .  #
#  ### ### #
#  $       #
#  ### ### #
#          #
############